{
  "id": "custom-1783336060495",
  "name": "My Level",
  "charge": 8,
  "conveyorCapacity": 24,
  "minGroup": 2,
  "ballQueues": [
    [1, 0, 7, 6, 1, 7, 3, 5, 1, 3, 0, 2, 3, 6, 7, 5],
    [3, 2, 2, 0, 7, 4, 4, 5, 2, 0, 6, 6, 1, 5, 4, 4]
  ],
  "columns": [
    [3, 3, 3, 3, 3, 7, 7, 6, 6, 6, 6, 6, 7, 7, 7, 7, 7, 7, 4, 4, 4, 4, 4, 4, 4, 7, 7, 7, 0, 0, 0, 0],
    [4, 4, 4, 4, 4, 4, 4, 5, 5, 5, 5, 5, 2, 2, 1, 1, 2, 2, 2, 2, 2, 2, 2, 3, 3, 3, 3, 3, 7, 7, 7, 7],
    [6, 6, 6, 6, 6, 3, 3, 3, 3, 6, 6, 6, 4, 4, 4, 4, 4, 2, 2, 2, 2, 2, 2, 3, 3, 3, 1, 1, 1, 1, 1, 1],
    [0, 0, 0, 0, 6, 6, 6, 6, 2, 2, 0, 0, 3, 3, 3, 7, 7, 4, 4, 4, 4, 4, 4, 4, 2, 2, 2, 2, 2, 0, 0, 0, 0, 0, 0],
    [6, 6, 6, 6, 6, 6, 0, 0, 0, 0, 2, 2, 2, 2, 2, 2, 2, 7, 7, 7, 7, 1, 1, 1, 5, 5, 5, 5, 5],
    [0, 0, 0, 0, 0, 0, 4, 4, 4, 4, 4, 4, 1, 1, 1, 1, 3, 3, 3, 3, 3, 3, 3, 2, 2, 2, 6, 6, 6],
    [5, 5, 3, 3, 3, 3, 3, 7, 7, 7, 7, 7, 7, 1, 1, 5, 5, 5, 5, 7, 7, 7, 7, 7, 5, 5, 5, 5, 6, 6, 6, 6, 6, 6],
    [1, 1, 1, 1, 1, 1, 0, 0, 0, 0, 0, 0, 1, 1, 1, 5, 5, 5, 5, 5, 5, 1, 1, 1, 1, 1, 1, 5, 5, 5, 5, 5, 5]
  ]
}
